MapLines,ReduceWords,MapTime,GroupTime,ReduceTime,TotalTime
1000,100,2099,406,335,2840
1000,200,1610,454,198,2262
1000,500,1388,452,46,1886
1000,1000,1538,302,48,1888
2000,100,1726,314,263,2303
2000,200,1512,323,62,1897
2000,500,1669,334,46,2049
2000,1000,1762,279,113,2154
5000,100,1291,331,92,1714
5000,200,1877,368,67,2312
5000,500,1640,396,41,2077
5000,1000,1439,365,193,1997
10000,100,1285,359,94,1738
10000,200,1598,359,98,2055
10000,500,1489,314,68,1871
10000,1000,1460,332,47,1839
